NO ./textures/TECH_0E.xpm
SO ./textures/TECH_2B.xpm
WE ./textures/TECH_4E.xpm
EA ./textures/TECH_4C.xpm
F 21, 67, 96
C 66, 73, 73

111111111111111111111111111111111111111
11000000000000000011100010200000000111
111121111111110000000000001111100000011
11000010000002000100000001000001111111
111000100011111111111001211111211000011
111001100001011     110001E0000001001111
10100020001001    111100000111101111111
11100010011001    111000000000001111111
11111111111111    111111111111111111111
