NO ./textures/TECH_0E.xpm
SO ./textures/TECH_2B.xpm
WE ./textures/TECH_4E.xpm
EA ./textures/TECH_4C.xpm
F 21, 67, 96
C 66, 73, 73

111111111111111111111111111111111111111
110000000000000000111000100000000000111
111101111111000000000000001111100000011
110000000000011000100000001000001111111
111000100011111111111001101000000000011
111001100001011     110001E0000001001111
10100010001001    111100000111101111111
11100000011001    111000000000001111111
11111111111111    111111111111111111111
